666666666666666666
887888788887778777
787878787787778777
787878787787778777
787878787787778777
788878887788888777
788878887788888777
666666666666666666
666666666666666666