666666666666666666
888888888888888887
777777777777777787
888888888888888787
877777777777778787
878888888888888787
877777777777777787
888888888888888887
777777777777777777
666666666666666666
666666666666666666