66666666666666
33233323333222
23232323223222
23232323223222
23232323223222
23332333223333
66666666666666
66666666666666