666666666666666666
999999977779999999
999999555555999999
999997579999999999
999997599977799999
999997579555559999
999997577577757999
999999555599757999
999999977999757999
999999999977757999
999999955555559999
999999977777999999
666666666666666666
666666666666666666