66666666666666
11011101111000
01010101001000
01010101001000
01010101001000
01110111001111
66666666666666
66666666666666