441444144441111
141414141141111
141414141141111
141414141141111
141414141141111
141414141141111
144414441144111
111111111111111