66666666666666
88788878888777
78787878778777
78787878778777
78787878778777
78887888778888
66666666666666
66666666666666