66666666666666
99333333333399
99377799977399
99333333337379
99777977739379
33333999737379
97973779737399
99973339939399
99997737737379
99999933337333
66666666666666
66666666666666