66666666666666
55455545555444
45454545445444
45454545445444
45454545445444
45554555445555
66666666666666
66666666666666