666666666666666666
554555455554455544
454545454454454544
454545454454454544
454545454454454544
455545554455554555
666666666666666666
666666666666666666